2
26 15
   xxxxxxxxxxxxxxxxxxxx   
  xp                  px  
 x  m                   x 
x     x            x     x
x    x x          x x    x
x   x x x        x x x   x
x    x x          x x    x
x     x     x      x     x
 x         xxx          x 
  x       xxxxx        x  
  x                    x  
  x    xxxxxxxxxxxx    x  
  x    x x x x x xx    x  
  xp                  px  
   xxxxxxxxxxxxxxxxxxxx   
