1
15 10
xxxxxxxxxxxxxxx
xpO         Opx
xO&         &Ox
x             x
x    OOOO     x
x    OOOO     x
x             x
xO&         &Ox
xpO         Opx
xxxxxxxxxxxxxxx
