1
15 10
xxxxxxxxxxxxxxx
xp0         0px
x0&         &0x
x             x
x    0000     x
x    0000     x
x             x
x0&         &0x
xp0         0px
xxxxxxxxxxxxxxx
