4
15 10
xxxxxxxxxxxxxxx
xpO         Opx
xO& m     m &Ox
x  mm     mm  x
x    OOOOO    x
x    OOOOO    x
x  mm     mm  x
xO& m     m &Ox
xpO         Opx
xxxxxxxxxxxxxxx
